....................
....................
....................
....................
....................
......XX............
...XHX..............
.................X.X
...............X..X.
.............X..X...
...........XX.X....M
.........XT.........
.......XX...........
......X.............
....................
