....................
....................
....................
..XX................
.X.X...XX..........X
...X....X.........X.
M..X....X........X..
.X.X.............X.X
.....T........X..X..
...............X....
.E.................S
..X.................
X.................X.
....................
....................
