H X X X X X X X X K X X X S X X X K X X
X X X X E X X X X X X X K X X X X X X X
X X X X X X X X X X X X X X X X X X X X
X X X K X X X X X X X X X X X X X X X X
X X X X X X X X X X X X X X X X X X K X
X K X X X K X X X X X X X X X X X X X X
X X X X X X X X X X X X X X X X X X X X
X X X X X X X X X X X X X X X X X X X X
S X X X X X X X X X X X X X X X X X X X
X X X X X X X X X X X N X X X X X X X X
K X X X X X X X X X M M M X X X X X X X
X X X K X X X X X N M T M N X X X X X X
X X X X X X X X X X M M M X X X X X X X
X X X X X X X X X X X N X X X X X X X X
X X X X X X X X X X X X X X X X X X X X
X X X X X X X X X X X X X X X X X X X X
X X K X X X X X X X X X X X X X X X X X
X X X X X X X X X X X X X X X X X X X X
X X X K X X X X X X X X X X x X X X X X
X X X X X X X X X X X X X X X X X X X X