H X X X . . . . . . . . . . . . . . . .
X X X X . X X X X X X X . X X X X X X X
X X X X . E X X X X X X . X X M X X X X
X X X X . X X X X X X X . X X X X X X X
X X X X . X X X X X . . . X X X X X X X
X E X X . X X X X X . . . X X X X X X S
X X X X . S X X X X . M . X X X X X X X
X X X X . X X X X X . . . X X X X X X X
S X X X . X X X X X . . . X X X X X X X
X X X X . X X X X X X X . X X X X X X X
X X X X . X X X X X X X . X X X X M X X
X X X X . X X X X X X X . M X X X X X X
X X X X . X X X X M X X . X X X X X X X
X . . . . . . . . . . . . X X X X X X X
X X X X . X X X X X X X X . X X X X X X
X X X X . X X X X X X X X . X X X X X X
X X X X . X X M X X X X X . X X X X X X
X N X X . X X X X X X X X . X N X X X X
X X X X . X X X X X X X X . X X X X X T
. . . . . . . . . . . . . . . . . . . .